%%%%%%%%
%P     %
%      %
% %%%% %
%G% G  %
%  .   %
%%%%%%%%