%%%%%%%%
%P    .%
%      %
% %%%% %
%G% G  %
%  .   %
%%%%%%%%