%%%%%%%
%.....%
%.%G%o%
%    P%
%%%%%%%