%%%%%%%
%P    %
% %G%.%
%.....%
%%%%%%%