%%%%%
% ..%
% %.%
% G.%
% %.%
%P .%
%%%%%