%%%%%
% ..%
% %.%
% G.%
% %.%
%Po.%
%%%%%