%%%%%%%
%    P%
%.%G%o%
%.....%
%%%%%%%