%%%%%
%. P%
%.% %
%.G %
%.% %
%.. %
%%%%%