%%%%%
%Po.%
% %.%
% G.%
% %.%
% ..%
%%%%%