%%%%%%%
%    P%
%.%G% %
%.....%
%%%%%%%