%%%%%%%
%.....%
%o%G%.%
%P    %
%%%%%%%