%%%%%
%.. %
%.% %
%.G %
%.% %
%.oP%
%%%%%