%%%%%
%.oP%
%.% %
%.G %
%.% %
%.. %
%%%%%