%%%%%%%
%P    %
%o%G%.%
%.....%
%%%%%%%