%%%%%
%.. %
%.% %
%.G %
%.% %
%. P%
%%%%%