%%%%%%%
%.....%
%.%G% %
%    P%
%%%%%%%