%%%%%
%P .%
% %.%
% G.%
% %.%
% ..%
%%%%%