%%%%%%%
%.....%
% %G%.%
%P    %
%%%%%%%