%%%%%
%.%P%
%.% %
%.  %
%.  %
%.G %
%%%%%