%%%%%%%
%.....%
%G  %%%
%    P%
%%%%%%%