%%%%%
% G.%
%  .%
%  .%
% %.%
%P%.%
%%%%%