%%%%%
%.G %
%.  %
%.o %
%.% %
%.%P%
%%%%%