%%%%%
%P%.%
% %.%
%  .%
%  .%
% G.%
%%%%%