%%%%%%%
%P    %
%%%o G%
%.....%
%%%%%%%