%%%%%%%
%    P%
%G o%%%
%.....%
%%%%%%%