%%%%%
% G.%
%  .%
% o.%
% %.%
%P%.%
%%%%%