%%%%%
%.%P%
%.% %
%.o %
%.  %
%.G %
%%%%%