%%%%%%%
%.....%
%%%o G%
%P    %
%%%%%%%