%%%%%
%.G %
%.  %
%.  %
%.% %
%.%P%
%%%%%