%%%%%%%
%.....%
%%%  G%
%P    %
%%%%%%%