%%%%%%%
%P    %
%%%  G%
%.....%
%%%%%%%