%%%%%
%P%.%
% %.%
% o.%
%  .%
% G.%
%%%%%