%%%%%%%
%.....%
%G o%%%
%    P%
%%%%%%%