%%%%%%%
%    P%
%G  %%%
%.....%
%%%%%%%