%%%%%%%%%%%
%...G..%%%%
%.%%...%%%%
%.%..%....%
%.%%.%...%%
%........P%
%%%%%%%%%%%
