%%%%%%%%
% .....%
%% %% .%
% P  %.%
%%%% %.%
% .G % %
%%.%%  %
% ...  %
%%%%%%%%