%%%%%%%%%
% % % % %
%...%P .%
%.%G% %.%
%.%   %.%
%  %%% .%
%   ....%
%%%%%%%%%