%%%%%%%%%
% % % % %
%. P%...%
%.% %G%.%
%.%   %.%
%. %%%  %
%....   %
%%%%%%%%%