%%%%%%%%
% ...  %
%%.%%  %
% .G % %
%%%% %.%
% P  %.%
%% %% .%
% .....%
%%%%%%%%