%%%%%%%%
% o... %
%  %%.%%
% % G. %
%.% %%%%
%.%  P %
%. %% %%
%..... %
%%%%%%%%