%%%%%%%%
%..... %
%. %% %%
%.%  P %
%.% %%%%
% % G. %
%  %%.%%
% o... %
%%%%%%%%