%%%%%%%%%
%....   %
%. %%%  %
%.%   %.%
%.% %G%.%
%. P%...%
% % % % %
%%%%%%%%%