%%%%%%%%%
%....   %
%. %%% o%
%.%   %.%
%.% %G%.%
%. P%...%
% % % % %
%%%%%%%%%