%%%%%%%%%
%   ....%
%o %%% .%
%.%   %.%
%.%G% %.%
%...%P .%
% % % % %
%%%%%%%%%