%%%%%%%%%
%   ....%
%  %%% .%
%.%   %.%
%.%G% %.%
%...%P .%
% % % % %
%%%%%%%%%