%%%%%%%%%
% % % % %
%. P%...%
%.% %G%.%
%.%   %.%
%. %%% o%
%....   %
%%%%%%%%%