%%%%%%%%
% ...o %
%%.%%  %
% .G % %
%%%% %.%
% P  %.%
%% %% .%
% .....%
%%%%%%%%