%%%%%%%
%.....%
%  Po.%
%G.   %
%%%%%%%