%%%%%
% ..%
% o.%
% P.%
%. .%
%G .%
%%%%%