%%%%%
% ..%
%  .%
% P.%
%. .%
%G .%
%%%%%