%%%%%%%
%   .G%
%. P  %
%.....%
%%%%%%%