%%%%%
%. G%
%. .%
%.P %
%.  %
%.. %
%%%%%