%%%%%
%.. %
%.o %
%.P %
%. .%
%. G%
%%%%%