%%%%%%%
%.....%
%.oP  %
%   .G%
%%%%%%%