%%%%%
%G .%
%. .%
% P.%
% o.%
% ..%
%%%%%