%%%%%
%.. %
%.  %
%.P %
%. .%
%. G%
%%%%%