%%%%%%%
%G.   %
%  P .%
%.....%
%%%%%%%