%%%%%%%
%.....%
%. P  %
%   .G%
%%%%%%%