%%%%%%%
%G.   %
%  Po.%
%.....%
%%%%%%%