%%%%%
%. G%
%. .%
%.P %
%.o %
%.. %
%%%%%