%%%%%%%
%.....%
%  P .%
%G.   %
%%%%%%%