%%%%%
%G .%
%. .%
% P.%
%  .%
% ..%
%%%%%