%%%%%%%
%   .G%
%.oP  %
%.....%
%%%%%%%