%%%%%%%
%.   .%
%.G   %
%%%   %
%.P   %
%.   .%
%%%%%%o