%%%%%%%
%..%..%
% G%P %
%     %
%     %
%.   .%
%%%%%%o