%%%%%%o
%.   .%
%     %
%     %
% G%P %
%..%..%
%%%%%%%