%%%%%%%
%.   .%
%   G.%
%   %%o
%   P.%
%.   .%
o%%%%%%