%%%%%%o
%.   .%
%.P   %
o%%   %
%.G   %
%.   .%
%%%%%%%