o%%%%%%
%.   .%
%   P.%
%   %%%
%   G.%
%.   .%
%%%%%%%