%%%%%%%
%..%..%
% P%G %
%     %
%     %
%.   .%
o%%%%%%