%%%%%%o
%.   .%
%.P   %
%%%   %
%.G   %
%.   .%
%%%%%%%