%%%%%%%
%.   .%
%.G   %
o%%   %
%.P   %
%.   .%
%%%%%%o