o%%%%%%
%.   .%
%     %
%     %
% P%G %
%..%..%
%%%%%%%