o%%%%%%
%.   .%
%   P.%
%   %%o
%   G.%
%.   .%
%%%%%%%