%%%%%%%
%.   .%
%   G.%
%   %%%
%   P.%
%.   .%
o%%%%%%