%%%%%%%
%o    %
% %.%.%
%  %G %
% P%G %
%   %.%
%  .  %
%.%   %
%%%%%%%