%%%%%%%%%%%
%..%o   ..%
%.   .    %
%. %.P   .%
%  %   % .%
%.G% ..% .%
%%%%%%%%%%%