%%%%%%%%%
%  .  . %
%  %GG% %
% . %%. %
%%  P % %
%.     o%
%%%%%%%%%