%%%%%%%
%    o%
%.%.% %
% G%  %
% G%P %
%.%   %
%  .  %
%   %.%
%%%%%%%