%%%%%%%%%
%.%G.%  %
%. o    %
%.% %.  %
%G.. %P%%
%%%%%%%%%