%%%%%%
%.  .%
%  o %
%.G P%
%%%%%%