%%%%%%%%%
% .  .  %
% %GG%  %
% .%% . %
% % P  %%
%o     .%
%%%%%%%%%