%%%%%%%%%
%G.. %P%%
%.% %.  %
%. o    %
%.%G.%  %
%%%%%%%%%