%%%%%%
%%   %
%P   %
%%. %%
% % .%
%. oG%
%.% %%
%G...%
%%%%%%