%%%%%%%%%
%.     o%
%%  P % %
% . %%. %
%  %GG% %
%  .  . %
%%%%%%%%%