%%%%%%
%...G%
%% %.%
%Go .%
%. % %
%% .%%
%   P%
%   %%
%%%%%%