%%%%%%%%
%   .  %
%. oG G%
% %%% .%
% ..  P%
%%%%%%%%