%%%%%%
% .  %
%  %.%
% o%.%
%.G% %
%    %
% G.P%
%%%%%%