%%%%%%
%P.G %
%    %
% %G.%
%.%o %
%.%  %
%  . %
%%%%%%