%%%%%%%%%
%o     .%
% % P  %%
% .%% . %
% %GG%  %
% .  .  %
%%%%%%%%%