%%%%%%
%   %%
%   P%
%% .%%
%. % %
%Go .%
%% %.%
%...G%
%%%%%%