%%%%%%
%G...%
%.% %%
%. oG%
% % .%
%%. %%
%P   %
%%   %
%%%%%%