%%%%%%%
%. % o%
%     %
%  %  %
%  %  %
%.G%P.%
%%%%%%%