%%%%%%%%%
%%P% ..G%
%  .% %.%
%    o .%
%  %.G%.%
%%%%%%%%%