%%%%%%%
%.%   %
%  .  %
%   %.%
% P%G %
%  %G %
% %.%.%
%o    %
%%%%%%%