%%%%%%%%
%P  .. %
%. %%% %
%G Go .%
%  .   %
%%%%%%%%