%%%%%%%%%
%  %.G%.%
%    o .%
%  .% %.%
%%P% ..G%
%%%%%%%%%