%%%%%%%
%    o%
%.%.% %
% G%  %
% G%  %
%.%   %
%  .  %
%   %.%
%%%%%%%