%%%%%%%
%   %.%
%  .  %
%.%   %
% G%P %
% G%  %
%.%.% %
%    o%
%%%%%%%