%%%%%%%
%   %.%
%oP G %
%.%...%
%%%%%%%