%%%%%
%. .%
%%G.%
%  .%
% P%%
%  .%
%%%%%