%%%%%%%
%.%...%
%oP G %
%   %.%
%%%%%%%