%%%%%%%
%...%.%
% G P %
%.%   %
%%%%%%%