%%%%%%%
%   %.%
% P G %
%.%...%
%%%%%%%