%%%%%%%
%.%   %
% G P %
%...%.%
%%%%%%%