%%%%%%%
%...%.%
% G Po%
%.%   %
%%%%%%%