%%%%%%%
%.%...%
% P G %
%   %.%
%%%%%%%