%%%%%
%. .%
%.G%%
%.  %
%%P %
%.o %
%%%%%