%%%%%
%.  %
%%P %
%.  %
%.G%%
%. .%
%%%%%