%%%%%
%.o %
%%P %
%.  %
%.G%%
%. .%
%%%%%