%%%%%
% o.%
% P%%
%  .%
%%G.%
%. .%
%%%%%