%%%%%
%. .%
%%G.%
%  .%
% P%%
% o.%
%%%%%