%%%%%%%
%.%   %
% G Po%
%...%.%
%%%%%%%