%%%%%
%  .%
% P%%
%  .%
%%G.%
%. .%
%%%%%