%%%%%
%. .%
%.G%%
%.  %
%%P %
%.  %
%%%%%